....................
.......XXXXXXXXXX...
.......X........X...
.......X........X...
..XXXXXX........X...
..X.............X...
..X.............X...
..X........XXXXXX...
..X........X........
..XXXX..XXXX........
.....XXXX...........
....................
....................